10
.o.....o..
....oo....
..o..oo...
.o......o.
.......o..
.o.....oo.
.o.oo.....
...o..o...
...ooo....
oo........
