10
.o....oo..
..o....ooo
.o....oo.o
.o.o....o.
..o.....oo
...ooo....
..oo.oooo.
..o.......
...o..ooo.
...o.oo..o
